Name,Tamil,English,Maths,Science,Social Science,Total,Rank
Arun,37,55,81,99,96,368,2
Bala,87,65,78,49,61,340,7
Charan,42,92,93,92,100,419,1
Deepak,92,44,38,71,87,332,8
Elan,84,67,95,64,43,353,5
Fathima,54,81,87,44,84,350,6
Gokul,72,74,95,63,57,361,3
Harini,92,95,42,80,52,361,3
Irfan,74,92,91,36,63,356,4
Jaya,38,48,43,81,82,292,9
